iroleid,imenuid,ccreateuser
"2","41","xcf"
"2","43","xcf"
"2","44","xcf"
"2","45","xcf"
"1","42","xcf"
"1","43","xcf"
"1","44","xcf"
"1","45","xcf"