iroleid,imenuid,ccreateuser
"1","80","xcf"
"2","80","xcf"
"1","81","xcf"
"2","81","xcf"
"1","82","xcf"
"2","82","xcf"
"1","83","xcf"
"2","83","xcf"